1111111111111111
10000000C0P0E001
1000D00000000001
1111111111111111
