11111111111111111111111111111111111
1000000000011100000000000000C000001
10000C000001E1000000000000000000101
10000000000101000000000000000000101
1000000C000000000000C00000000000101
1000000CCC0000000000000000000000101
1000000C00000000000000000000C0001P1
11111111111111111111111111111111111
