11111111111111111
100P0000000000E01
100111000C0000001
1111C10000000C001
100001000C0000001
11111111111111111
