11111111111111111
100P00000000001
100C000C0000C01
100E00000000001
11111111111111111
